NO map/textures/exit.xpm
SO map/textures/exit.xpm
WE map/textures/exit.xpm
EA map/textures/exit.xpm

C 125, 230, 4
F 124, 23, 14

11111111111111111111111111111111111111111111
10000000000000000000000000000000000000000001
10000000000000000000000000000000000000000001
10000000000000000000000000000000000000000001
10000000000000000000000000000000000000000001
10000000000000000000000000000000000000000001
10000000000000000000000000000000000000000001
10000000000000000000000000000000000000000001
10000000000000000000000000000000000000000001
10000000000000000000000000000000000000000001
10000000000000000000000000000000000000000001
100000000000000000000000000000000000000000011111111111111111
1000000000000000000111111111111111100000000000000000000000001
1000000000000000001            11110000000000000000000000001
1000000000000000001111111       100000000000000000000000001
1000000000000000000000000111111100000000000000000011111111
10000000000000000000000000000000000000000001111111
10000000000000000000000000000000000000000001
10000000000000000000000000000000000000000001
10000000000000000000000000000000000000000001
10000000000000000000000000000000000000000001
10000000000000000000000000000000000000000001
10000000000000000000000000000000000000000001
10000000000000000000000000000000000000000001
10000000000000000000000000000000000000000001
10000000000000000000000000000000000000000001
10000000000000000000000000000000000000000001
10000000000000000000000000000000000000000001
10000000000000000000000000000000000000000001
10000000000000000000000000000000000000000001
10000000000000000000000000000000000000000001
10000000000000000000000000000000000000000001
10000000000000000000000000000000000000000001
10000000000000000000000000000000000000000001
10000000000000000000000000000000000000000001
10000000000000000000000000000000000000000001
10001111111111111111111111111111111111111111
1001
1E01
1111